111111
1CCCP1
1CC111
1CCCC1
1CCCC1
1ECCC1
111111