1111111111111111111111111111111111111111111111111111111111111111
1E0000000000000C00000C000000000000000000000000000000000000000001
1010010100100000101001000000010100000000000000000000000000000001
1010010010101010001001000000010100000000000000000000000000000001
100000000C00C0000000000000000000000000000000000000000000000000C1
100000000000000C00000C000000000000000000000000000000000000000001
100000000000000C00000C000000000000000000000000000000000000000001
100000000000000C00000C000000000000000000000000000000000000000001
100000000000000C00000C000000000000000000000000000000000000000001
100000000000000C00000C000000000000000000000000000000000000000001
100000000000000C00000C000000000000000000000000000000000000000001
100000000000000C00000C000000000000000000000000000000000000000001
1010010100100000101001000000010100000000000000000000000000000001
1010010010101010001001000000010100000000000000000000000000000001
1010010100100000101001000000010100000000000000000000000000000001
101001001010101000100100000001010000000000000P000000000000000001
1010010100100000101001000000010100000000000000000000000000000001
1010010010101010001001000000010100000000000000000000000000000001
1010010100100000101001000000010100000000000000000000000000000001
1010010010101010001001000000010100000000000000000000000000000001
1010010100100000101001000000010100000000000000000000000000000001
1010010010101010001001000000010100000000000000000000000000000001
1010010100100000101001000000010100000000000000000000000000000001
1010010010101010001001000000010100000000000000000000000000000001
1010010100100000101001000000010100000000000000000000000000000001
1010010010101010001001000000010100000000000000000000000000000001
1010010100100000101001000000010100000000000000000000000000000001
1010010100100000101001000000010100000000000000000000000000000001
1010010100100000101001000000010100000000000000000000000000C00001
101001001C101010001001000000010100000000000000000000000000CC0001
101001001C101010001001000000010100000000000000000000000000000001
101001001010101000100100000001C100000000000000000000000000000001
1111111111111111111111111111111111111111111111111111111111111111
